  ####
### @#####
#  ooo   #
# ##x##  #
##     ###
# x###x #
#       #
#########