###############
#    #   #    #
# o  #   #o   #
#   @         #
######   ######
     #  x#
     # ox#
     #  x#
     #####