    ##### #####
  ###   ###   #
  #@o #  o    #
  #o#x######o##
### xxxx#  # #
#   x x #  # #
# # xxxx#  # #
# #    ##### #
# o ##o#   # #
###oo  #o  # ##
  #           #
  ##  #  o# o #
   #####  ##  #
       ########